Day,daily_new_cases,daily_recovered_cases,new_deaths,infectious,cumulative_cases,cumulative_infectious,cumulative_recovered,cumulative_deaths,school_closures,workplace_closures,cancel_public_events,restriction_gatherings,stay_home_requirements,facial_coverings,public_information_campaigns,close_public_transport,restrictions_internal_movements,international_travel_controls,testing_policy,contact_tracing,vaccination_policy,childhood_vaccine_availability,vaccine_eligibility_age,income_support,debt_relief,vaccine_eligibility_age_categorical
2020-03-03,3,0,0,24,24,24,0,0,0,0,0,0,0,0,2,0,0,3,1,0,0,0,nil,0,0,0
2020-03-04,0,0,0,24,24,48,0,0,0,0,2,1,0,0,2,0,0,3,1,0,0,0,nil,0,0,0
2020-03-05,9,0,0,33,33,81,0,0,0,0,2,1,0,0,2,0,0,3,1,0,0,0,nil,0,0,0
2020-03-06,4,0,0,37,37,118,0,0,0,0,2,1,0,0,2,0,0,3,1,0,0,0,nil,0,0,0
2020-03-07,4,0,0,41,41,159,0,0,0,0,2,1,0,0,2,0,0,3,1,0,0,0,nil,0,0,0
2020-03-08,9,0,0,50,50,209,0,0,0,0,2,1,0,0,2,0,0,3,1,0,0,0,nil,0,1,0
2020-03-09,4,0,0,54,54,263,0,0,0,0,2,1,0,0,2,0,0,3,1,0,0,0,nil,0,1,0
2020-03-10,33,0,0,87,87,350,0,0,0,0,2,1,0,0,2,0,0,3,1,0,0,0,nil,0,1,0
2020-03-11,18,0,0,105,105,455,0,0,0,0,2,1,0,0,2,0,0,3,1,0,0,0,nil,0,1,0
2020-03-12,23,0,0,128,128,583,0,0,0,0,2,3,0,0,2,0,0,4,1,1,0,0,nil,0,1,0
2020-03-13,35,1,0,162,163,745,1,0,3,0,2,3,0,0,2,0,0,4,1,1,0,0,nil,0,1,0
2020-03-14,29,0,0,191,192,936,1,0,3,0,2,3,0,0,2,0,0,4,1,1,0,0,nil,0,1,0
2020-03-15,40,0,0,231,232,1167,1,0,3,2,2,4,0,0,2,0,0,4,1,1,0,0,nil,0,1,0
2020-03-16,73,0,0,304,305,1471,1,0,3,2,2,4,0,0,2,1,0,4,1,1,0,0,nil,0,2,0
2020-03-17,94,2,0,396,399,1867,3,0,3,2,2,4,1,0,2,1,1,4,1,2,0,0,nil,0,2,0
2020-03-18,125,2,0,519,524,2386,5,0,3,2,2,4,1,0,2,1,1,4,1,2,0,0,nil,0,2,0
2020-03-19,135,4,0,650,659,3036,9,0,3,2,2,4,1,0,2,1,1,4,1,2,0,0,nil,0,2,0
2020-03-20,168,1,1,817,827,3853,10,1,3,2,2,4,2,0,2,1,1,4,1,2,0,0,nil,0,2,0
2020-03-21,209,0,0,1026,1036,4879,10,1,3,2,2,4,2,0,2,1,1,4,1,2,0,0,nil,0,2,0
2020-03-22,252,5,0,1273,1288,6152,15,1,3,2,2,4,2,0,2,1,1,4,1,2,0,0,nil,0,2,0
2020-03-23,349,5,0,1617,1637,7769,20,1,3,2,2,4,2,0,2,1,1,4,1,2,0,0,nil,0,2,0
2020-03-24,418,5,3,2030,2055,9799,25,4,3,2,2,4,2,0,2,1,1,4,1,2,0,0,nil,0,2,0
2020-03-25,423,6,1,2447,2478,12246,31,5,3,2,2,4,2,0,2,1,1,4,1,2,0,0,nil,0,2,0
2020-03-26,519,9,5,2957,2997,15203,40,10,3,2,2,4,2,0,2,1,1,4,1,2,0,0,nil,0,2,0
2020-03-27,431,18,2,3370,3428,18573,58,12,3,2,2,4,2,0,2,1,1,4,1,2,0,0,nil,0,2,0
2020-03-28,476,9,1,3837,3904,22410,67,13,3,2,2,4,2,0,2,1,1,4,1,2,0,0,nil,0,2,0
2020-03-29,529,14,3,4352,4433,26762,81,16,3,2,2,4,2,0,2,1,1,4,1,2,0,0,nil,0,2,0
2020-03-30,549,33,1,4868,4982,31630,114,17,3,2,2,4,2,0,2,1,1,4,1,2,0,0,nil,0,2,0
2020-03-31,737,43,4,5562,5719,37192,157,21,3,2,2,4,2,0,2,1,1,4,1,2,0,0,nil,2,2,0
2020-04-01,693,32,8,6223,6412,43415,189,29,3,3,2,4,2,3,2,1,1,4,1,2,0,0,nil,2,2,0
2020-04-02,724,77,9,6870,7136,50285,266,38,3,3,2,4,2,3,2,1,1,4,1,2,0,0,nil,2,2,0
2020-04-03,600,54,5,7416,7736,57701,320,43,3,3,2,4,2,3,2,1,2,4,1,2,0,0,nil,2,2,0
2020-04-04,427,52,6,7791,8163,65492,372,49,3,3,2,4,2,3,2,1,2,4,1,2,0,0,nil,2,2,0
2020-04-05,584,100,7,8275,8747,73767,472,56,3,3,2,4,2,3,2,1,2,4,1,2,0,0,nil,2,2,0
2020-04-06,449,118,8,8606,9196,82373,590,64,3,3,2,4,2,3,2,1,2,4,1,2,0,0,nil,2,2,0
2020-04-07,376,120,8,8862,9572,91235,710,72,3,3,2,4,2,3,2,1,2,4,1,2,0,0,nil,2,2,0
2020-04-08,340,105,8,9097,9912,100332,815,80,3,3,2,4,3,3,2,1,2,4,1,2,0,0,nil,2,2,0
2020-04-09,340,110,9,9327,10252,109659,925,89,3,3,2,4,3,3,2,1,2,4,1,2,0,0,nil,2,2,0
2020-04-10,355,123,8,9559,10607,119218,1048,97,3,3,2,4,3,3,2,1,2,4,1,2,0,0,nil,2,2,0
2020-04-11,342,119,6,9782,10949,129000,1167,103,3,3,2,4,3,3,2,1,2,4,1,2,0,0,nil,2,2,0
2020-04-12,551,258,6,10075,11500,139075,1425,109,3,3,2,4,3,3,2,1,2,4,1,2,0,0,nil,2,2,0
2020-04-13,437,277,9,10235,11937,149310,1702,118,3,3,2,4,3,3,2,1,2,4,1,2,0,0,nil,2,2,0
2020-04-14,393,285,8,10343,12330,159653,1987,126,3,3,2,4,3,3,2,1,2,4,1,2,0,0,nil,2,2,0
2020-04-15,305,275,13,10373,12635,170026,2262,139,3,3,2,4,3,3,2,1,2,4,1,2,0,0,nil,2,2,0
2020-04-16,296,328,7,10341,12931,180367,2590,146,3,3,2,4,3,3,2,1,2,4,1,2,0,0,nil,2,2,0
2020-04-17,297,355,9,10283,13228,190650,2945,155,3,3,2,4,3,3,2,1,2,4,1,2,0,0,nil,2,2,0
2020-04-18,288,249,11,10322,13516,200972,3194,166,3,3,2,4,3,3,2,1,2,4,1,2,0,0,nil,2,2,0
2020-04-19,274,379,8,10217,13790,211189,3573,174,3,3,2,4,2,3,2,1,2,4,1,2,0,0,nil,2,2,0
2020-04-20,297,447,6,10067,14087,221256,4020,180,3,3,2,4,2,3,2,1,2,4,1,2,0,0,nil,2,2,0
2020-04-21,279,371,10,9975,14366,231231,4391,190,3,3,2,4,2,3,2,1,2,4,1,2,0,0,nil,2,2,0
2020-04-22,226,390,3,9811,14592,241042,4781,193,3,3,2,4,2,3,2,1,2,4,1,2,0,0,nil,2,2,0
2020-04-23,274,326,4,9759,14866,250801,5107,197,3,3,2,4,2,3,2,1,2,4,1,2,0,0,nil,2,2,0
2020-04-24,250,336,3,9673,15116,260474,5443,200,3,3,2,4,2,3,2,1,2,4,1,2,0,0,nil,2,2,0
2020-04-25,159,374,3,9458,15275,269932,5817,203,3,3,2,4,2,3,2,1,2,4,1,2,0,0,nil,2,2,0
2020-04-26,82,429,2,9111,15357,279043,6246,205,3,2,2,4,2,3,2,1,2,4,1,2,0,0,nil,2,2,0
2020-04-27,127,466,4,8772,15484,287815,6712,209,3,2,2,4,2,3,2,1,2,4,1,2,0,0,nil,2,2,0
2020-04-28,161,563,5,8370,15645,296185,7275,214,3,2,2,4,2,3,2,1,2,4,1,2,0,0,nil,2,2,0
2020-04-29,82,349,6,8103,15727,304288,7624,220,3,2,2,4,2,3,2,1,2,4,1,2,0,0,nil,2,2,0
2020-04-30,143,426,6,7820,15870,312108,8050,226,3,2,2,4,2,3,2,1,2,4,1,2,0,0,nil,2,2,0
2020-05-01,116,421,4,7515,15986,319623,8471,230,3,2,2,4,2,3,2,1,2,4,1,2,0,0,nil,2,2,0
2020-05-02,57,275,3,7297,16043,326920,8746,233,3,2,2,4,2,3,2,1,2,4,1,2,0,0,nil,2,2,0
2020-05-03,26,284,3,7039,16069,333959,9030,236,2,2,2,4,2,3,2,1,2,4,1,2,0,0,nil,2,2,0
2020-05-04,55,257,3,6837,16124,340796,9287,239,2,2,2,4,2,3,2,1,2,4,1,2,0,0,nil,2,2,0
2020-05-05,33,315,2,6555,16157,347351,9602,241,2,2,2,3,2,3,2,1,2,4,1,2,0,0,nil,2,2,0
2020-05-06,65,259,1,6361,16222,353712,9861,242,2,2,2,3,2,3,2,1,2,4,1,2,0,0,nil,2,2,0
2020-05-07,61,224,1,6198,16283,359910,10085,243,2,2,2,3,2,3,2,1,2,4,1,2,0,0,nil,2,2,0
2020-05-08,33,222,6,6009,16316,365919,10307,249,2,2,2,3,2,3,2,1,2,4,1,2,0,0,nil,2,2,0
2020-05-09,20,90,3,5939,16336,371858,10397,252,2,2,2,3,2,3,2,1,2,4,1,2,0,0,nil,2,2,0
2020-05-10,29,168,4,5800,16365,377658,10565,256,2,2,2,3,2,3,2,1,2,4,1,2,0,0,nil,2,2,0
2020-05-11,39,327,5,5512,16404,383170,10892,261,2,2,2,3,2,3,2,1,2,4,1,2,0,0,nil,2,2,0
2020-05-12,23,257,3,5278,16427,388448,11149,264,2,2,2,3,2,3,2,1,2,4,1,2,0,0,nil,2,2,0
2020-05-13,39,176,3,5141,16466,393589,11325,267,2,2,2,3,2,3,2,1,2,4,1,2,0,0,nil,2,2,0
2020-05-14,22,238,3,4925,16488,398514,11563,270,2,2,2,3,2,3,2,1,2,4,1,2,0,0,nil,2,2,0
2020-05-15,12,159,0,4778,16500,403292,11722,270,2,2,2,3,2,3,2,1,2,4,1,2,0,0,nil,2,2,0
2020-05-16,5,99,3,4684,16505,407976,11821,273,2,2,2,3,2,3,2,1,2,4,1,2,0,0,nil,2,2,0
2020-05-17,15,147,4,4552,16520,412528,11968,277,2,2,2,3,2,3,2,1,2,4,1,2,0,0,nil,2,2,0
2020-05-18,27,272,3,4307,16547,416835,12240,280,2,2,2,3,2,3,2,1,2,4,1,2,0,0,nil,2,2,0
2020-05-19,22,149,2,4180,16569,421015,12389,282,2,2,2,3,2,3,2,1,2,4,1,2,0,0,nil,2,2,0
2020-05-20,15,109,1,4086,16584,425101,12498,283,2,2,2,2,2,3,2,1,2,4,1,2,0,0,nil,2,2,0
2020-05-21,18,121,0,3983,16602,429084,12619,283,2,2,2,2,2,3,2,1,2,4,1,2,0,0,nil,2,2,0
2020-05-22,19,160,0,3842,16621,432926,12779,283,2,2,2,2,2,3,2,1,2,4,1,2,0,0,nil,2,2,0
2020-05-23,5,42,0,3805,16626,436731,12821,283,2,2,2,2,2,3,2,1,2,4,1,2,0,0,nil,2,2,0
2020-05-24,13,114,1,3704,16639,440435,12935,284,2,2,2,2,2,3,2,1,2,4,1,2,0,0,nil,2,2,0
2020-05-25,22,132,2,3594,16661,444029,13067,286,2,2,2,2,2,3,2,1,2,4,1,2,0,0,nil,2,2,0
2020-05-26,50,89,0,3555,16711,447584,13156,286,2,2,2,2,2,3,2,1,2,4,1,2,0,0,nil,2,2,0
2020-05-27,40,59,2,3536,16751,451120,13215,288,2,2,2,2,2,3,2,1,2,4,1,2,0,0,nil,2,2,0
2020-05-28,77,112,1,3501,16828,454621,13327,289,2,2,2,2,2,3,2,1,2,4,1,2,0,0,nil,2,2,0
2020-05-29,113,39,0,3575,16941,458196,13366,289,2,2,2,2,2,3,2,1,2,4,1,2,0,0,nil,2,2,0
2020-05-30,29,40,0,3564,16970,461760,13406,289,2,2,2,2,2,3,2,1,2,4,1,2,0,0,nil,2,2,0
2020-05-31,87,60,0,3591,17057,465351,13466,289,2,2,2,2,2,3,2,1,2,4,2,2,0,0,nil,2,2,0
2020-06-01,100,67,3,3624,17157,468975,13533,292,2,2,2,2,2,3,2,1,2,4,2,2,0,0,nil,2,2,0
2020-06-02,122,53,2,3693,17279,472668,13586,294,2,2,2,2,2,3,2,1,2,4,2,2,0,0,nil,2,2,0
2020-06-03,96,27,1,3762,17375,476430,13613,295,2,2,2,2,2,3,2,1,2,4,2,2,0,0,nil,2,2,0
2020-06-04,142,42,0,3862,17517,480292,13655,295,2,2,2,2,2,3,2,1,2,4,2,2,0,0,nil,2,2,0
2020-06-05,127,37,1,3952,17644,484244,13692,296,2,2,2,2,2,3,2,1,2,4,2,2,0,0,nil,2,2,0
2020-06-06,78,24,4,4006,17722,488250,13716,300,2,2,2,2,2,3,2,1,2,4,2,2,0,0,nil,2,2,0
2020-06-07,140,42,2,4104,17862,492354,13758,302,2,2,2,2,2,3,2,1,2,4,2,2,0,0,nil,2,2,0
2020-06-08,179,39,0,4244,18041,496598,13797,302,2,2,2,2,2,3,2,1,2,4,2,1,0,0,nil,2,2,0
2020-06-09,174,46,1,4372,18215,500970,13843,303,2,2,2,2,2,3,2,1,2,4,2,1,0,0,nil,2,2,0
2020-06-10,241,51,1,4562,18456,505532,13894,304,2,2,2,2,2,3,2,1,2,4,2,1,0,0,nil,2,2,0
2020-06-11,193,55,0,4700,18649,510232,13949,304,2,2,2,2,2,3,2,1,2,4,2,1,0,0,nil,2,2,0
2020-06-12,184,53,0,4831,18833,515063,14002,304,2,2,2,2,2,3,2,1,2,4,2,1,0,0,nil,2,2,0
2020-06-13,149,41,1,4939,18982,520002,14043,305,2,2,2,2,2,3,2,1,2,4,2,1,0,0,nil,2,2,0
2020-06-14,137,50,2,5026,19119,525028,14093,307,2,2,2,2,2,3,2,1,2,4,2,1,0,0,nil,2,2,0
2020-06-15,200,88,0,5138,19319,530166,14181,307,2,2,2,2,2,3,2,1,2,4,2,1,0,0,nil,2,2,0
2020-06-16,297,51,1,5384,19616,535550,14232,308,2,2,2,2,2,3,2,1,2,4,2,1,0,0,nil,2,2,0
2020-06-17,268,48,0,5604,19884,541154,14280,308,2,2,2,2,2,3,2,1,2,4,2,1,0,0,nil,2,2,0
2020-06-18,303,50,0,5857,20187,547011,14330,308,2,2,2,2,2,3,2,1,2,4,2,1,0,0,nil,2,2,0
2020-06-19,311,57,1,6111,20498,553122,14387,309,2,2,2,2,2,3,2,1,2,4,2,1,0,0,nil,2,2,0
2020-06-20,160,37,1,6234,20658,559356,14424,310,2,2,2,2,2,3,2,1,2,4,2,1,0,0,nil,2,2,0
2020-06-21,174,49,0,6359,20832,565715,14473,310,2,2,2,2,2,3,2,1,2,4,2,1,0,0,nil,2,2,0
2020-06-22,344,60,1,6643,21176,572358,14533,311,2,2,2,2,2,3,2,1,2,4,2,1,0,0,nil,2,2,0
2020-06-23,452,84,2,7011,21628,579369,14617,313,2,2,2,2,2,3,2,1,2,4,2,1,0,0,nil,2,2,0
2020-06-24,485,72,3,7424,22113,586793,14689,316,2,2,2,2,2,3,2,1,2,4,2,1,0,0,nil,2,2,0
2020-06-25,516,76,4,7864,22629,594657,14765,320,2,2,2,2,2,3,2,1,2,4,2,1,0,0,nil,2,2,0
2020-06-26,463,130,3,8197,23092,602854,14895,323,2,2,2,2,2,3,2,1,2,4,2,2,0,0,nil,2,2,0
2020-06-27,397,50,3,8544,23489,611398,14945,326,2,2,2,2,2,3,2,1,2,4,2,2,0,0,nil,2,2,0
2020-06-28,383,139,2,8788,23872,620186,15084,328,2,2,2,2,2,3,2,1,2,4,2,2,0,0,nil,2,2,0
2020-06-29,759,166,0,9381,24631,629567,15250,328,2,2,2,2,2,3,2,1,2,4,2,2,0,0,nil,2,2,0
2020-06-30,789,127,1,10043,25420,639610,15377,329,1,2,2,2,2,3,2,1,2,4,2,2,0,0,nil,2,2,0
2020-07-01,966,98,3,10911,26386,650521,15475,332,1,2,2,2,2,3,2,1,2,4,2,2,0,0,nil,2,2,0
2020-07-02,1153,124,1,11940,27539,662461,15599,333,1,2,2,2,2,3,2,1,2,4,2,2,0,0,nil,2,2,0
2020-07-03,941,119,3,12762,28480,675223,15718,336,1,2,2,2,2,3,2,1,2,4,2,2,0,0,nil,2,2,0
2020-07-04,819,76,5,13505,29299,688728,15794,341,1,2,2,2,2,3,2,1,2,4,2,2,0,0,nil,2,2,0
2020-07-05,824,143,2,14186,30123,702914,15937,343,1,2,2,2,2,3,2,1,2,4,2,1,0,0,nil,2,2,0
2020-07-06,1128,193,8,15121,31251,718035,16130,351,2,2,2,3,2,3,2,1,2,4,2,1,0,0,nil,2,2,0
2020-07-07,1383,172,5,16332,32634,734367,16302,356,2,2,2,3,2,3,2,1,2,4,2,1,0,0,nil,2,2,0
2020-07-08,1329,225,5,17436,33963,751803,16527,361,2,2,2,3,2,3,2,1,2,4,2,1,0,0,nil,2,2,0
2020-07-09,1520,225,5,18731,35483,770534,16752,366,2,2,2,3,2,3,2,1,2,4,2,1,0,0,nil,2,2,0
2020-07-10,1404,210,4,19925,36887,790459,16962,370,2,2,2,3,2,3,2,1,2,4,2,1,0,0,nil,2,2,0
2020-07-11,1168,191,5,20902,38055,811361,17153,375,2,2,2,3,2,3,2,1,2,4,2,1,0,0,nil,2,2,0
2020-07-12,1236,336,7,21802,39291,833163,17489,382,2,2,2,3,2,3,2,1,2,4,2,1,0,0,nil,2,2,0
2020-07-13,1717,360,4,23159,41008,856322,17849,386,1,1,2,3,2,3,2,1,2,4,2,1,0,0,nil,2,2,0
2020-07-14,1601,313,7,24447,42609,880769,18162,393,1,1,2,3,2,3,2,1,2,4,2,1,0,0,nil,2,2,0
2020-07-15,1873,361,6,25959,44482,906728,18523,399,1,1,2,3,2,3,2,1,2,4,2,1,0,0,nil,2,2,0
2020-07-16,1936,508,9,27387,46418,934115,19031,408,1,1,2,3,2,3,2,1,2,4,2,1,0,0,nil,2,2,0
2020-07-17,1601,481,12,28507,48019,962622,19512,420,1,1,2,3,2,3,2,1,2,4,2,1,0,0,nil,2,2,0
2020-07-18,1444,447,8,29504,49463,992126,19959,428,1,1,2,3,0,3,2,1,0,4,2,1,0,0,nil,2,2,0
2020-07-19,1016,516,10,30004,50479,1022130,20475,438,1,1,2,3,0,3,2,1,0,4,2,1,0,0,nil,2,2,0
2020-07-20,1887,624,12,31267,52366,1053397,21099,450,1,1,2,3,0,3,2,1,0,4,2,1,0,0,nil,2,2,0
2020-07-21,2004,640,9,32631,54370,1086028,21739,459,1,1,2,3,0,3,2,1,0,4,2,1,0,0,nil,2,2,0
2020-07-22,2039,3700,6,30970,56409,1116998,25439,465,1,1,2,3,0,3,2,1,0,4,2,1,0,0,nil,2,2,0
2020-07-23,1987,6689,16,26268,58396,1143266,32128,481,1,1,2,3,0,3,2,1,0,4,2,1,0,0,nil,2,2,0
2020-07-24,1824,1586,8,26506,60220,1169772,33714,489,1,1,2,3,0,3,2,1,0,4,2,1,0,0,nil,2,2,0
2020-07-25,1110,587,7,27029,61330,1196801,34301,496,1,1,2,3,0,3,2,1,0,4,2,1,0,0,nil,2,2,0
2020-07-26,1040,2714,10,25355,62370,1222156,37015,506,1,1,2,3,0,3,2,1,0,4,2,1,0,0,nil,2,2,0
2020-07-27,2048,1749,7,25654,64418,1247810,38764,513,1,1,2,3,0,3,2,1,0,4,2,1,0,0,nil,2,2,0
2020-07-28,2120,1547,8,26227,66538,1274037,40311,521,1,1,2,3,0,3,2,1,0,4,2,1,0,0,nil,2,2,0
2020-07-29,1957,1391,15,26793,68495,1300830,41702,536,1,1,2,3,0,3,2,1,0,4,2,1,0,0,nil,2,2,0
2020-07-30,1786,1674,15,26905,70281,1327735,43376,551,1,1,2,3,0,3,2,1,0,4,2,1,0,0,nil,2,2,0
2020-07-31,1359,1291,14,26973,71640,1354708,44667,565,1,1,2,3,0,3,2,1,0,4,2,1,0,0,nil,2,2,0
2020-08-01,622,532,14,27063,72262,1381771,45199,579,1,1,2,3,0,3,2,1,0,4,2,1,0,0,nil,2,2,0
2020-08-02,708,2422,12,25349,72970,1407120,47621,591,1,1,2,3,0,3,2,1,0,4,2,1,0,0,nil,2,2,0
2020-08-03,1799,1776,15,25372,74769,1432492,49397,606,1,1,2,3,0,3,2,1,0,4,2,1,0,0,nil,2,2,0
2020-08-04,1724,1639,11,25457,76493,1457949,51036,617,1,1,2,3,0,3,2,1,0,4,2,1,0,0,nil,2,2,0
2020-08-05,1686,1475,10,25668,78179,1483617,52511,627,1,1,2,3,0,3,2,1,0,4,2,1,0,0,nil,2,2,0
2020-08-06,1675,1739,9,25604,79854,1509221,54250,636,1,1,2,3,0,3,2,1,0,4,2,1,0,0,nil,2,2,0
2020-08-07,1760,1204,12,26160,81614,1535381,55454,648,1,1,0,3,0,3,2,1,0,4,2,1,0,0,nil,2,2,0
2020-08-08,754,602,13,26312,82368,1561693,56056,661,1,1,0,3,0,3,2,1,0,4,2,1,0,0,nil,2,2,0
2020-08-09,922,2323,8,24911,83290,1586604,58379,669,1,1,0,3,0,3,2,1,0,4,2,1,0,0,nil,2,2,0
2020-08-10,1696,1389,15,25218,84986,1611822,59768,684,1,1,0,3,0,3,2,1,0,4,2,1,0,0,nil,2,2,0
2020-08-11,1822,984,11,26056,86808,1637878,60752,695,1,1,0,3,0,3,2,1,0,4,2,1,0,0,nil,2,2,0
2020-08-12,1615,1132,16,26539,88423,1664417,61884,711,1,1,0,3,0,3,2,1,0,4,2,1,0,0,nil,2,2,0
2020-08-13,1641,1301,16,26879,90064,1691296,63185,727,1,1,0,3,0,3,2,1,0,4,2,1,0,0,nil,2,2,0
2020-08-14,1389,984,12,27284,91453,1718580,64169,739,1,1,0,3,0,3,2,1,0,4,2,1,0,0,nil,2,2,0
2020-08-15,754,566,10,27472,92207,1746052,64735,749,1,1,0,3,0,3,2,1,0,4,2,1,0,0,nil,2,2,0
2020-08-16,1069,2212,20,26329,93276,1772381,66947,769,1,1,0,3,0,3,2,1,0,2,2,1,0,0,nil,2,2,0
2020-08-17,1649,1183,4,26795,94925,1799176,68130,773,1,1,0,3,0,3,2,1,0,2,2,1,0,0,nil,2,2,0
2020-08-18,1645,1113,14,27327,96570,1826503,69243,787,1,1,0,3,0,3,2,1,0,2,2,1,0,0,nil,2,2,0
2020-08-19,1638,1465,12,27500,98208,1854003,70708,799,1,1,0,3,0,3,2,1,0,2,2,1,0,0,nil,2,2,0
2020-08-20,1485,1424,14,27561,99693,1881564,72132,813,1,1,0,3,0,3,2,1,0,2,2,1,0,0,nil,2,2,0
2020-08-21,1491,1035,13,28017,101184,1909581,73167,826,1,1,0,3,0,3,2,1,0,2,2,1,0,0,nil,2,2,0
2020-08-22,710,661,10,28066,101894,1937647,73828,836,1,1,0,3,0,3,2,1,0,2,2,1,0,0,nil,2,2,0
2020-08-23,964,2107,13,26923,102858,1964570,75935,849,1,1,0,3,0,3,2,1,0,2,2,1,0,0,nil,2,2,0
2020-08-24,1901,1394,16,27430,104759,1992000,77329,865,1,1,0,3,0,3,2,1,0,2,2,1,0,0,nil,2,2,0
2020-08-25,1957,791,19,28596,106716,2020596,78120,884,1,1,0,3,0,3,2,1,0,2,2,1,0,0,nil,2,2,0
2020-08-26,1984,3624,11,26956,108700,2047552,81744,895,1,1,0,3,0,3,2,1,0,2,2,1,0,0,nil,2,2,0
2020-08-27,2106,1507,11,27555,110806,2075107,83251,906,1,1,0,3,0,3,2,1,0,2,2,1,0,0,nil,2,2,0
2020-08-28,1833,1828,13,27560,112639,2102667,85079,919,1,1,0,3,0,3,2,1,0,2,2,1,0,0,nil,2,2,0
2020-08-29,907,705,5,27762,113546,2130429,85784,924,1,1,0,3,0,3,2,1,0,2,2,1,0,0,nil,2,2,0
2020-08-30,1099,2244,14,26617,114645,2157046,88028,938,1,1,0,3,0,3,2,1,0,2,2,1,0,0,nil,2,2,0
2020-08-31,2171,1463,23,27325,116816,2184371,89491,961,1,1,0,3,0,3,2,1,0,2,2,1,0,0,nil,2,2,0
2020-09-01,2254,1006,15,28573,119070,2212944,90497,976,1,1,0,3,0,3,2,1,0,2,2,1,0,0,nil,2,2,0
2020-09-02,3193,1392,13,30374,122263,2243318,91889,989,1,1,0,3,0,3,2,1,0,2,2,1,0,0,nil,2,2,0
2020-09-03,2665,1790,16,31249,124928,2274567,93679,1005,1,1,0,3,0,3,2,1,0,2,2,1,0,0,nil,2,2,0
2020-09-04,2623,1187,12,32685,127551,2307252,94866,1017,1,1,0,3,0,3,2,1,0,2,2,1,0,0,nil,2,2,0
2020-09-05,1503,882,15,33306,129054,2340558,95748,1032,1,1,0,3,0,3,2,1,0,2,2,1,0,0,nil,2,2,0
2020-09-06,2176,2386,12,33096,131230,2373654,98134,1044,1,1,0,3,0,3,2,1,0,2,2,1,0,0,nil,2,2,0
2020-09-07,3385,1588,17,34893,134615,2408547,99722,1061,1,1,0,3,0,3,2,1,0,2,2,1,0,0,nil,2,2,0
2020-09-08,3487,1421,20,36959,138102,2445506,101143,1081,1,1,0,3,0,3,2,1,0,2,2,1,0,0,nil,2,2,0
2020-09-09,3991,1460,15,39490,142093,2484996,102603,1096,1,1,0,3,0,3,2,1,0,2,2,1,0,0,nil,2,2,0
2020-09-10,4152,1971,14,41671,146245,2526667,104574,1110,1,1,0,3,0,3,2,1,0,2,2,1,0,0,nil,2,2,0
2020-09-11,3972,1764,20,43879,150217,2570546,106338,1130,1,1,0,3,0,3,2,1,0,2,2,1,0,0,nil,2,2,0
2020-09-12,2718,1257,15,45340,152935,2615886,107595,1145,1,1,0,3,0,3,2,1,0,2,2,1,0,0,nil,2,2,0
2020-09-13,3172,3258,17,45254,156107,2661140,110853,1162,1,1,0,3,0,3,2,1,0,2,2,1,0,0,nil,2,2,0
2020-09-14,4803,2388,20,47669,160910,2708809,113241,1182,1,1,0,3,0,3,2,1,0,2,2,1,0,0,nil,2,2,0
2020-09-15,5527,2257,16,50939,166437,2759748,115498,1198,1,1,0,3,0,3,2,1,0,2,2,1,0,0,nil,2,2,0
2020-09-16,4567,2783,26,52723,171004,2812471,118281,1224,1,1,0,3,0,3,2,1,0,2,2,1,0,0,nil,2,2,0
2020-09-17,5378,3696,17,54405,176382,2866876,121977,1241,1,1,0,3,0,3,2,1,0,2,2,1,0,0,nil,2,2,0
2020-09-18,5333,2827,21,56911,181715,2923787,124804,1262,3,2,2,4,2,3,2,1,2,2,2,1,0,0,nil,2,2,0
2020-09-19,3809,1433,28,59287,185524,2983074,126237,1290,3,2,2,4,2,3,2,1,2,2,2,1,0,0,nil,2,2,0
2020-09-20,2576,2464,21,59399,188100,3042473,128701,1311,3,2,2,4,2,3,2,1,2,2,2,1,0,0,nil,2,2,0
2020-09-21,3869,4631,32,58637,191969,3101110,133332,1343,3,2,2,4,2,3,2,1,2,2,2,1,0,0,nil,2,2,0
2020-09-22,7019,3500,25,62156,198988,3163266,136832,1368,3,2,2,4,2,3,2,1,2,2,2,1,0,0,nil,2,2,0
2020-09-23,7142,3801,25,65497,206130,3228763,140633,1393,3,2,2,4,2,3,2,1,2,2,2,1,0,0,nil,2,2,0
2020-09-24,8258,4564,31,69191,214388,3297954,145197,1424,3,2,2,4,2,3,2,1,2,2,2,1,0,0,nil,2,2,0
2020-09-25,8385,4117,29,73459,222773,3371413,149314,1453,3,3,2,4,2,3,2,1,2,2,2,1,0,0,nil,2,2,0
2020-09-26,5879,2388,27,76950,228652,3448363,151702,1480,3,3,2,4,2,3,2,1,2,2,2,1,0,0,nil,2,2,0
2020-09-27,3436,5658,31,74728,232088,3523091,157360,1511,3,3,2,4,2,3,2,1,2,2,2,1,0,0,nil,2,2,0
2020-09-28,1153,2158,29,73723,233241,3596814,159518,1540,3,3,2,4,2,3,2,1,2,2,2,1,0,0,nil,2,2,0
2020-09-29,4986,5758,35,72951,238227,3669765,165276,1575,3,3,2,4,2,3,2,1,2,2,2,1,0,0,nil,2,2,0
2020-09-30,9051,5093,37,76909,247278,3746674,170369,1612,3,3,2,4,2,3,2,1,2,2,2,1,0,0,nil,2,2,0
2020-10-01,7717,5740,46,78886,254995,3825560,176109,1658,3,3,2,4,2,3,2,1,2,2,2,1,0,0,nil,2,2,0
2020-10-02,7053,5563,25,80376,262048,3905936,181672,1683,3,3,2,4,2,3,2,1,2,2,2,1,0,0,nil,2,2,0
2020-10-03,2593,3478,38,79491,264641,3985427,185150,1721,3,3,2,4,2,3,2,1,2,2,2,1,0,0,nil,2,2,0
2020-10-04,2931,8084,37,74338,267572,4059765,193234,1758,3,3,2,4,2,3,2,1,2,2,2,1,0,0,nil,2,2,0
2020-10-05,5700,6932,27,73106,273272,4132871,200166,1785,3,3,2,4,2,3,2,1,2,2,2,1,0,0,nil,2,2,0
2020-10-06,4717,6387,45,71436,277989,4204307,206553,1830,3,3,2,4,2,3,2,1,2,2,2,1,0,0,nil,2,2,0
2020-10-07,4152,4874,26,70714,282141,4275021,211427,1856,3,3,2,4,2,3,2,1,2,2,2,1,0,0,nil,2,2,0
2020-10-08,3752,4779,47,69687,285893,4344708,216206,1903,3,3,2,4,2,3,2,1,2,2,2,1,0,0,nil,2,2,0
2020-10-09,2954,5078,40,67563,288847,4412271,221284,1943,3,3,2,4,2,3,2,1,2,2,2,1,0,0,nil,2,2,0
2020-10-10,915,3774,35,64704,289762,4476975,225058,1978,3,3,2,4,2,3,2,1,2,2,2,1,0,0,nil,2,2,0
2020-10-11,1637,7521,45,58820,291399,4535795,232579,2023,3,3,2,4,2,3,2,1,2,2,2,1,0,0,nil,1,2,0
2020-10-12,3153,5493,30,56480,294552,4592275,238072,2053,3,3,2,4,2,4,2,1,2,2,1,2,0,0,nil,1,2,0
2020-10-13,2335,5695,37,53120,296887,4645395,243767,2090,3,3,2,4,2,4,2,1,2,2,1,2,0,0,nil,1,2,0
2020-10-14,2117,5815,34,49422,299004,4694817,249582,2124,3,3,2,4,2,4,2,1,2,2,1,2,0,0,nil,1,2,0
2020-10-15,1609,5391,32,45640,300613,4740457,254973,2156,3,3,2,4,2,4,2,1,2,2,1,2,0,0,nil,1,2,0
2020-10-16,1496,3468,35,43668,302109,4784125,258441,2191,3,3,2,4,2,4,2,1,2,2,1,2,0,0,nil,1,2,0
2020-10-17,410,2498,32,41580,302519,4825705,260939,2223,3,3,2,4,2,4,2,1,2,2,1,2,0,0,nil,1,2,0
2020-10-18,921,4881,33,37620,303440,4863325,265820,2256,3,3,2,4,2,4,2,1,2,2,1,2,0,0,nil,1,2,0
2020-10-19,1517,2317,31,36820,304957,4900145,268137,2287,3,3,2,4,2,4,2,1,2,2,1,2,0,0,nil,1,2,0
2020-10-20,1192,1784,20,36228,306149,4936373,269921,2307,3,3,2,4,2,4,2,1,2,2,1,2,0,0,nil,1,2,0
2020-10-21,1169,3105,25,34292,307318,4970665,273026,2332,3,3,2,4,2,4,2,1,2,2,1,2,0,0,nil,1,2,0
2020-10-22,1031,3092,29,32231,308349,5002896,276118,2361,3,3,2,4,2,4,2,1,2,2,1,2,0,0,nil,1,2,0
2020-10-23,849,2418,26,30662,309198,5033558,278536,2387,3,3,2,4,2,4,2,1,2,2,1,2,0,0,nil,1,2,0
2020-10-24,247,1291,26,29618,309445,5063176,279827,2413,3,3,2,4,2,4,2,1,2,2,1,2,0,0,nil,1,2,0
2020-10-25,604,2655,34,27567,310049,5090743,282482,2447,3,3,2,4,2,4,2,1,2,2,1,2,0,0,nil,1,2,0
2020-10-26,883,1280,28,27170,310932,5117913,283762,2475,3,3,2,4,2,4,2,1,2,2,1,2,0,0,nil,1,2,0
2020-10-27,885,950,28,27105,311817,5145018,284712,2503,3,3,2,4,2,4,2,1,2,2,1,2,0,0,nil,1,2,0
2020-10-28,724,1281,10,26548,312541,5171566,285993,2513,3,2,1,3,0,4,2,0,0,2,1,2,0,0,nil,1,2,0
2020-10-29,647,1433,19,25762,313188,5197328,287426,2532,2,2,1,3,0,4,2,0,0,2,1,2,0,0,nil,1,2,0
2020-10-30,681,1055,12,25388,313869,5222716,288481,2544,2,2,1,3,0,4,2,0,0,2,1,2,0,0,nil,1,2,0
2020-10-31,228,793,25,24823,314097,5247539,289274,2569,2,2,1,3,0,4,2,0,0,2,1,2,0,0,nil,1,2,0
2020-11-01,657,1498,19,23982,314754,5271521,290772,2588,2,2,1,3,0,4,2,0,0,2,1,2,0,0,nil,1,2,0
2020-11-02,792,910,15,23864,315546,5295385,291682,2603,2,2,1,3,0,4,2,0,0,2,1,2,0,0,nil,1,2,0
2020-11-03,844,720,26,23988,316390,5319373,292402,2629,2,2,1,3,0,4,2,0,0,2,1,2,0,0,nil,1,2,0
2020-11-04,769,630,15,24127,317159,5343500,293032,2644,2,2,2,3,2,4,2,0,2,3,3,2,0,0,nil,2,1,0
2020-11-05,568,836,14,23859,317727,5367359,293868,2658,2,2,2,3,2,4,2,0,2,3,3,2,0,0,nil,2,1,0
2020-11-06,688,884,16,23663,318415,5391022,294752,2674,2,2,2,3,2,4,2,0,2,3,3,2,0,0,nil,2,1,0
2020-11-07,212,680,8,23195,318627,5414217,295432,2682,2,2,2,3,2,4,2,0,2,3,3,2,0,0,nil,2,1,0
2020-11-08,534,678,7,23051,319161,5437268,296110,2689,2,2,2,3,2,4,2,0,2,3,3,2,0,0,nil,2,1,0
2020-11-09,722,917,8,22856,319883,5460124,297027,2697,2,2,2,3,2,4,2,0,2,3,3,2,0,0,nil,2,1,0
2020-11-10,674,335,10,23195,320557,5483319,297362,2707,2,2,2,3,2,4,2,0,2,3,3,2,0,0,nil,2,1,0
2020-11-11,768,1077,7,22886,321325,5506205,298439,2714,2,2,2,3,2,4,2,0,2,3,3,2,0,0,nil,2,1,0
2020-11-12,836,1198,12,22524,322161,5528729,299637,2726,2,2,2,3,2,4,2,0,2,3,3,2,0,0,nil,2,1,0
2020-11-13,760,731,5,22553,322921,5551282,300368,2731,2,2,2,3,2,4,2,0,2,3,3,2,0,0,nil,2,1,0
2020-11-14,291,418,11,22426,323212,5573708,300786,2742,2,2,2,3,2,4,2,0,2,3,3,2,0,0,nil,2,1,0
2020-11-15,626,960,14,22092,323838,5595800,301746,2756,2,2,2,3,2,4,2,0,2,3,3,2,0,0,nil,2,1,0
2020-11-16,874,652,9,22314,324712,5618114,302398,2765,2,2,2,3,2,4,2,0,2,3,3,2,0,0,nil,2,1,0
2020-11-17,830,576,12,22568,325542,5640682,302974,2777,2,2,2,3,2,4,2,0,2,3,3,2,0,0,nil,2,1,0
2020-11-18,796,786,7,22578,326338,5663260,303760,2784,2,2,2,3,2,4,2,0,2,3,3,2,0,0,nil,2,1,0
2020-11-19,770,747,8,22601,327108,5685861,304507,2792,2,2,2,3,2,4,2,0,2,3,3,2,0,0,nil,2,1,0
2020-11-20,772,665,6,22708,327880,5708569,305172,2798,2,2,2,3,2,4,2,0,2,3,3,2,0,0,nil,2,1,0
2020-11-21,423,446,12,22685,328303,5731254,305618,2810,2,2,2,3,2,4,2,0,2,3,3,2,0,0,nil,2,1,0
2020-11-22,763,991,16,22457,329066,5753711,306609,2826,2,2,2,3,2,4,2,0,2,3,3,2,0,0,nil,2,1,0
2020-11-23,961,652,7,22766,330027,5776477,307261,2833,2,2,2,3,2,4,2,0,2,3,3,2,0,0,nil,2,1,0
2020-11-24,859,540,5,23085,330886,5799562,307801,2838,2,2,2,3,2,4,2,0,2,3,3,2,0,0,nil,2,1,0
2020-11-25,1082,836,5,23331,331968,5822893,308637,2843,2,2,2,3,2,4,2,0,2,3,3,2,0,0,nil,2,1,0
2020-11-26,1083,918,9,23496,333051,5846389,309555,2852,2,2,2,3,2,4,2,0,2,3,3,2,0,0,nil,2,1,0
2020-11-27,1033,677,7,23852,334084,5870241,310232,2859,2,2,2,3,2,4,2,0,2,3,3,2,0,0,nil,2,1,0
2020-11-28,581,410,9,24023,334665,5894264,310642,2868,2,2,2,3,2,4,2,0,2,3,3,2,0,0,nil,2,1,0
2020-11-29,1026,1095,10,23954,335691,5918218,311737,2878,2,2,2,3,2,4,2,0,2,3,3,2,0,0,nil,2,1,0
2020-11-30,1257,725,6,24486,336948,5942704,312462,2884,2,2,2,3,2,4,2,0,2,3,3,2,0,0,nil,2,1,0
2020-12-01,1199,694,10,24991,338147,5967695,313156,2894,2,2,2,3,2,4,2,0,2,3,3,2,0,0,nil,2,1,0
2020-12-02,1588,829,5,25750,339735,5993445,313985,2899,2,2,2,3,2,4,2,0,2,3,3,2,0,0,nil,2,1,0
2020-12-03,1448,1419,10,25779,341183,6019224,315404,2909,2,2,2,3,2,4,2,0,2,3,3,2,0,0,nil,2,1,0
2020-12-04,1515,859,9,26435,342698,6045659,316263,2918,2,2,2,3,2,4,2,0,2,3,3,2,0,0,nil,2,1,0
2020-12-05,1000,588,10,26847,343698,6072506,316851,2928,2,2,2,3,2,4,2,0,2,3,3,2,0,0,nil,2,1,0
2020-12-06,1358,1386,8,26819,345056,6099325,318237,2936,2,2,2,3,2,4,2,0,2,3,3,2,0,0,nil,2,1,0
2020-12-07,1864,903,7,27780,346920,6127105,319140,2943,2,2,2,3,2,4,2,0,2,3,3,2,0,0,nil,2,1,0
2020-12-08,1769,889,12,28660,348689,6155765,320029,2955,2,2,2,3,2,4,2,0,2,3,3,2,0,0,nil,2,1,0
2020-12-09,1869,1019,13,29510,350558,6185275,321048,2968,2,2,2,3,2,4,2,0,2,3,3,2,0,0,nil,2,1,0
2020-12-10,2006,1426,13,30090,352564,6215365,322474,2981,2,2,2,3,2,4,2,0,2,3,3,2,0,0,nil,2,1,0
2020-12-11,1834,1142,11,30782,354398,6246147,323616,2992,2,2,2,3,2,4,2,0,2,3,3,2,0,0,nil,2,1,0
2020-12-12,1298,912,16,31168,355696,6277315,324528,3008,2,2,2,3,2,4,2,0,2,3,3,2,0,0,nil,2,1,0
2020-12-13,1726,1890,9,31004,357422,6308319,326418,3017,2,2,2,3,2,4,2,0,2,3,3,2,0,0,nil,2,1,0
2020-12-14,2321,1255,11,32070,359743,6340389,327673,3028,2,2,2,3,2,4,2,0,2,3,3,2,0,0,nil,2,1,0
2020-12-15,2893,1193,15,33770,362636,6374159,328866,3043,2,2,2,3,2,3,2,1,2,3,3,2,0,0,nil,2,1,0
2020-12-16,2860,1611,15,35019,365496,6409178,330477,3058,2,2,2,3,2,3,2,1,2,3,3,2,0,0,nil,2,1,0
2020-12-17,2847,1934,17,35932,368343,6445110,332411,3075,2,2,2,3,2,3,2,1,2,3,3,2,0,0,nil,2,1,0
2020-12-18,2791,1543,16,37180,371134,6482290,333954,3091,2,2,2,3,2,3,2,1,2,3,3,2,0,0,nil,2,1,0
2020-12-19,1888,1080,20,37988,373022,6520278,335034,3111,2,2,2,3,2,3,2,1,2,3,3,2,3,1,60,2,1,1
2020-12-20,3094,2543,18,38539,376116,6558817,337577,3129,2,2,2,3,2,3,2,1,2,3,3,2,3,1,60,2,1,1
2020-12-21,3860,1544,16,40855,379976,6599672,339121,3145,2,2,2,3,2,3,2,1,2,3,3,2,3,1,60,2,1,1
2020-12-22,4380,1616,13,43619,384356,6643291,340737,3158,2,2,2,3,2,3,2,1,2,4,3,2,3,1,60,2,1,1
2020-12-23,4037,2013,25,45643,388393,6688934,342750,3183,2,2,2,3,2,3,2,1,2,4,3,2,3,1,60,2,1,1
2020-12-24,4048,2854,15,46837,392441,6735771,345604,3198,2,2,2,3,2,3,2,1,2,4,3,2,3,1,60,2,1,1
2020-12-25,4005,2387,21,48455,396446,6784226,347991,3219,2,2,2,3,2,3,2,1,2,4,3,2,3,1,60,2,1,1
2020-12-26,2658,1794,23,49319,399104,6833545,349785,3242,2,2,2,3,2,3,2,1,2,4,3,2,3,1,60,2,1,1
2020-12-27,3533,4177,21,48675,402637,6882220,353962,3263,2,3,2,3,2,3,2,1,2,4,3,2,3,1,60,2,1,1
2020-12-28,5521,2464,32,51732,408158,6933952,356426,3295,2,3,2,3,2,3,2,1,2,4,3,2,3,1,60,2,1,1
2020-12-29,5632,2374,25,54990,413790,6988942,358800,3320,2,3,2,3,2,3,2,1,2,4,3,2,3,1,60,2,1,1
2020-12-30,5869,3712,16,57147,419659,7046089,362512,3336,2,3,2,3,2,3,2,1,2,4,3,2,3,1,60,2,1,1
2020-12-31,5864,4233,36,58778,425523,7104867,366745,3372,2,3,2,3,2,3,2,1,2,4,3,2,3,1,60,2,1,1
2021-01-01,6011,3430,34,61359,431534,7166226,370175,3406,2,3,2,3,2,3,2,1,2,4,3,2,3,1,60,2,1,1
2021-01-02,4212,2029,27,63542,435746,7229768,372204,3433,2,3,2,3,2,3,2,1,2,4,3,2,3,1,60,2,1,1
2021-01-03,5230,5542,26,63230,440976,7292998,377746,3459,2,3,2,3,2,3,2,1,2,4,3,2,3,1,60,2,1,1
2021-01-04,8424,3067,38,68587,449400,7361585,380813,3497,2,3,2,3,2,3,2,1,2,4,3,2,3,1,60,2,1,1
2021-01-05,8226,2943,23,73870,457626,7435455,383756,3520,2,3,2,3,2,3,2,1,2,4,3,2,3,1,60,2,1,1
2021-01-06,7883,4750,43,77003,465509,7512458,388506,3563,2,3,2,3,2,3,2,1,2,4,3,2,3,1,60,2,1,1
2021-01-07,7662,5827,48,78838,473171,7591296,394333,3611,2,3,2,4,2,3,2,1,2,4,3,2,3,1,60,2,1,1
2021-01-08,8160,4813,46,82185,481331,7673481,399146,3657,2,3,2,4,2,3,2,1,2,4,3,2,3,1,60,2,1,1
2021-01-09,5164,3060,20,84289,486495,7757770,402206,3677,2,3,2,4,2,3,2,1,2,4,3,2,3,1,60,2,1,1
2021-01-10,6954,8316,43,82927,493449,7840697,410522,3720,2,3,2,4,2,3,2,1,2,4,3,2,3,1,60,2,1,1
2021-01-11,9727,4823,28,87831,503176,7928528,415345,3748,2,3,2,4,2,3,2,1,2,4,3,2,3,1,60,2,1,1
2021-01-12,9295,4546,55,92580,512471,8021108,419891,3803,2,3,2,4,2,3,2,1,2,4,3,2,3,1,55,2,1,2
2021-01-13,9470,7977,57,94073,521941,8115181,427868,3860,2,3,2,4,2,3,2,1,2,4,3,2,3,1,55,2,1,2
2021-01-14,9297,9144,59,94226,531238,8209407,437012,3919,2,3,2,4,2,3,2,1,2,4,3,2,3,1,55,2,1,2
2021-01-15,8428,7963,52,94691,539666,8304098,444975,3971,2,3,2,4,2,3,2,1,2,4,3,2,3,1,55,2,1,2
2021-01-16,5085,4260,47,95516,544751,8399614,449235,4018,2,3,2,4,2,3,2,1,2,4,3,2,3,1,55,2,1,2
2021-01-17,5659,10858,56,90317,550410,8489931,460093,4074,2,3,2,4,2,3,2,1,2,4,3,2,3,1,55,2,1,2
2021-01-18,10120,6136,46,94301,560530,8584232,466229,4120,2,3,2,4,2,3,2,1,2,4,3,2,4,1,45,2,1,3
2021-01-19,8631,5470,43,97462,569161,8681694,471699,4163,2,3,2,4,2,3,2,1,2,4,3,2,4,1,40,2,1,4
2021-01-20,8361,8732,57,97091,577522,8778785,480431,4220,2,3,2,4,2,3,2,1,2,4,3,2,4,1,35,2,1,5
2021-01-21,7268,9920,47,94439,584790,8873224,490351,4267,2,3,2,4,2,3,2,1,2,4,3,2,4,1,35,2,1,5
2021-01-22,7387,8410,65,93416,592177,8966640,498761,4332,2,3,2,4,2,3,2,1,2,4,3,2,4,1,35,2,1,5
2021-01-23,2447,4160,52,91703,594624,9058343,502921,4384,2,3,2,4,2,3,2,1,2,4,3,2,4,1,35,2,1,5
2021-01-24,4935,10484,75,86154,599559,9144497,513405,4459,2,3,2,4,2,3,2,1,2,4,3,2,4,1,35,2,1,5
2021-01-25,8716,5590,60,89280,608275,9233777,518995,4519,2,3,2,4,2,3,2,1,2,4,3,2,4,1,35,2,1,5
2021-01-26,7817,5070,53,92027,616092,9325804,524065,4572,2,3,2,4,2,3,2,1,2,4,3,2,4,1,35,2,1,5
2021-01-27,7750,8634,61,91143,623842,9416947,532699,4633,2,3,2,4,2,3,2,1,2,4,3,2,4,1,35,2,1,5
2021-01-28,7196,9179,49,89160,631038,9506107,541878,4682,2,3,2,4,2,3,2,1,2,4,3,2,4,1,16,2,1,6
2021-01-29,6775,7511,45,88424,637813,9594531,549389,4727,2,3,2,4,2,3,2,1,2,4,3,2,4,1,16,2,1,6
2021-01-30,2627,3528,38,87523,640440,9682054,552917,4765,2,3,2,4,2,3,2,1,2,4,3,2,4,1,16,2,1,6
2021-01-31,5238,10051,51,82710,645678,9764764,562968,4816,2,3,2,4,2,3,2,1,2,4,3,2,4,1,16,2,1,6
2021-02-01,8930,5099,46,86541,654608,9851305,568067,4862,2,3,2,4,2,3,2,1,2,4,3,2,4,1,16,2,1,6
2021-02-02,8021,4379,61,90183,662629,9941488,572446,4923,2,3,2,4,2,3,2,1,2,4,3,2,4,1,16,2,1,6
2021-02-03,7464,8148,57,89499,670093,10030987,580594,4980,2,3,2,4,2,3,2,1,2,4,3,2,4,2,16,2,1,6
2021-02-04,7261,8102,48,88658,677354,10119645,588696,5028,2,3,2,4,2,3,2,1,2,4,3,2,4,2,16,2,1,6
2021-02-05,6599,7222,34,88035,683953,10207680,595918,5062,2,3,2,4,2,3,2,1,2,4,3,2,4,2,16,2,1,6
2021-02-06,2658,3038,51,87655,686611,10295335,598956,5113,2,3,2,4,2,3,2,1,2,4,3,2,4,2,16,2,1,6
2021-02-07,4605,9674,44,82586,691216,10377921,608630,5157,2,2,2,4,0,3,2,1,0,4,3,2,4,2,16,2,1,6
2021-02-08,7854,4966,30,85474,699070,10463395,613596,5187,2,2,2,4,0,3,2,1,0,4,3,2,4,2,16,2,1,6
2021-02-09,6172,4895,42,86751,705242,10550146,618491,5229,2,2,2,4,0,3,2,1,0,4,3,2,4,2,16,2,1,6
2021-02-10,5676,8211,32,84216,710918,10634362,626702,5261,2,2,2,4,0,3,2,1,0,4,3,2,4,2,16,2,1,6
2021-02-11,5084,8703,30,80597,716002,10714959,635405,5291,2,2,2,4,0,3,2,1,0,4,3,2,4,2,16,2,1,6
2021-02-12,4674,7190,41,78081,720676,10793040,642595,5332,2,2,2,4,0,3,2,1,0,4,3,2,4,2,16,2,1,6
2021-02-13,1890,3380,29,76591,722566,10869631,645975,5361,2,2,2,4,0,3,2,1,0,4,3,2,4,2,16,2,1,6
2021-02-14,3489,9557,37,70523,726055,10940154,655532,5398,2,2,2,4,0,3,2,1,0,4,3,2,4,2,16,2,1,6
2021-02-15,5199,4839,16,70883,731254,11011037,660371,5414,2,2,2,4,0,3,2,1,0,4,3,2,4,2,16,2,1,6
2021-02-16,4584,3725,42,71742,735838,11082779,664096,5456,2,2,2,4,0,3,2,1,0,4,3,2,4,2,16,2,1,6
2021-02-17,4169,6477,27,69434,740007,11152213,670573,5483,2,2,2,4,0,3,2,1,0,4,3,2,4,2,16,2,1,6
2021-02-18,3337,7438,35,65333,743344,11217546,678011,5518,2,2,2,4,0,3,2,1,0,4,3,2,4,2,16,2,1,6
2021-02-19,3793,5879,22,63247,747137,11280793,683890,5540,2,2,2,4,0,3,2,1,0,4,3,2,4,2,16,2,1,6
2021-02-20,1255,3368,26,61134,748392,11341927,687258,5566,2,2,2,4,0,3,2,1,0,4,3,2,4,2,16,2,1,6
2021-02-21,3113,7363,25,56884,751505,11398811,694621,5591,2,2,2,4,0,3,2,1,0,4,3,2,5,2,16,2,1,6
2021-02-22,4811,3644,15,58051,756316,11456862,698265,5606,2,2,2,4,0,3,2,1,0,4,3,2,5,2,16,2,1,6
2021-02-23,4442,3144,35,59349,760758,11516211,701409,5641,2,2,2,4,0,3,2,1,0,4,3,2,5,2,16,2,1,6
2021-02-24,4377,5336,27,58390,765135,11574601,706745,5668,2,2,2,4,0,3,2,1,0,4,3,2,5,2,16,2,1,6
2021-02-25,3820,4973,23,57237,768955,11631838,711718,5691,2,3,2,4,2,3,2,1,2,4,3,2,5,2,16,2,1,6
2021-02-26,3819,3728,22,57328,772774,11689166,715446,5713,2,3,2,4,2,3,2,1,2,4,3,2,5,2,16,2,1,6
2021-02-27,1443,1560,30,57211,774217,11746377,717006,5743,2,3,2,4,2,3,2,1,2,4,3,2,5,2,16,2,1,6
2021-02-28,3029,5616,21,54624,777246,11801001,722622,5764,2,2,2,4,0,3,2,1,0,4,3,2,5,2,16,2,1,6
2021-03-01,4854,2724,18,56754,782100,11857755,725346,5782,2,2,2,4,0,3,2,1,0,4,3,2,5,2,16,2,1,6
2021-03-02,4404,2907,21,58251,786504,11916006,728253,5803,2,2,2,4,0,3,2,1,0,4,3,2,5,2,16,2,1,6
2021-03-03,4671,4568,17,58354,791175,11974360,732821,5820,2,2,2,4,0,3,2,1,0,4,3,2,5,2,16,2,1,6
2021-03-04,3659,4748,17,57265,794834,12031625,737569,5837,2,2,2,4,0,3,2,1,0,4,3,2,5,2,16,2,1,6
2021-03-05,3695,3950,18,57010,798529,12088635,741519,5855,2,2,2,4,0,3,2,1,0,4,3,2,5,2,16,2,1,6
2021-03-06,1841,1907,20,56944,800370,12145579,743426,5875,2,2,2,4,0,3,2,1,0,4,3,2,5,2,16,2,1,6
2021-03-07,2367,5668,16,53643,802737,12199222,749094,5891,2,2,2,4,0,3,2,1,0,4,3,2,5,2,16,2,1,6
2021-03-08,3798,2664,21,54777,806535,12253999,751758,5912,2,2,2,4,0,3,2,1,0,4,3,2,5,2,16,2,1,6
2021-03-09,3127,2903,15,55001,809662,12309000,754661,5927,2,2,2,4,0,3,2,1,0,4,3,2,5,2,16,2,1,6
2021-03-10,2843,4531,17,53313,812505,12362313,759192,5944,2,2,2,4,0,3,2,1,0,4,3,2,5,2,16,2,1,6
2021-03-11,2553,4946,18,50920,815058,12413233,764138,5962,2,2,2,4,0,3,2,1,0,4,3,2,5,2,16,2,1,6
2021-03-12,2414,3874,12,49460,817472,12462693,768012,5974,2,2,2,4,0,3,2,1,0,4,3,2,5,2,16,2,1,6
2021-03-13,787,2009,16,48238,818259,12510931,770021,5990,2,2,2,4,0,3,2,1,0,4,3,2,5,2,16,2,1,6
2021-03-14,1436,5769,26,43905,819695,12554836,775790,6016,2,2,2,4,0,3,2,1,0,4,3,2,5,2,16,2,1,6
2021-03-15,2130,2605,17,43430,821825,12598266,778395,6033,2,2,2,4,0,3,2,1,0,4,3,2,5,2,16,2,1,6
2021-03-16,1563,2220,16,42773,823388,12641039,780615,6049,2,2,2,4,0,3,2,1,0,4,3,2,5,2,16,2,1,6
2021-03-17,1544,3605,14,40712,824932,12681751,784220,6063,2,2,2,4,0,3,2,1,0,4,3,2,5,2,16,2,1,6
2021-03-18,1261,3567,9,38406,826193,12720157,787787,6072,2,2,2,4,0,3,2,1,0,4,3,2,5,2,16,2,1,6
2021-03-19,1087,2532,12,36961,827280,12757118,790319,6084,2,2,2,4,0,3,2,1,0,4,3,2,5,2,16,2,1,6
2021-03-20,350,1450,7,35861,827630,12792979,791769,6091,2,2,2,4,0,3,2,1,0,4,3,2,5,2,16,2,1,6
2021-03-21,681,3466,14,33076,828311,12826055,795235,6105,2,2,2,4,0,3,2,1,0,4,3,2,5,2,16,2,1,6
2021-03-22,992,1672,13,32396,829303,12858451,796907,6118,2,2,2,4,0,3,2,1,0,4,3,2,5,2,16,2,1,6
2021-03-23,694,736,14,32354,829997,12890805,797643,6132,2,2,2,4,0,3,2,1,0,4,3,2,5,2,16,2,1,6
2021-03-24,480,2236,10,30598,830477,12921403,799879,6142,2,2,2,4,0,3,2,1,0,4,3,2,5,2,16,2,1,6
2021-03-25,906,2091,9,29413,831383,12950816,801970,6151,2,2,2,4,0,3,2,1,0,4,3,2,5,2,16,2,1,6
2021-03-26,546,1489,11,28470,831929,12979286,803459,6162,2,2,1,2,0,3,2,1,0,4,3,2,5,2,16,2,1,6
2021-03-27,244,856,6,27858,832173,13007144,804315,6168,2,2,1,2,0,3,2,1,0,4,3,2,5,2,16,2,1,6
2021-03-28,134,877,13,27115,832307,13034259,805192,6181,2,2,1,2,0,3,2,1,0,4,3,2,5,2,16,2,1,6
2021-03-29,391,1467,11,26039,832698,13060298,806659,6192,2,2,1,2,0,3,2,1,0,4,3,2,5,2,16,2,1,6
2021-03-30,459,809,13,25689,833157,13085987,807468,6205,2,2,1,2,0,3,2,1,0,4,3,2,5,2,16,2,1,6
2021-03-31,500,1069,14,25120,833657,13111107,808537,6219,2,2,1,2,0,3,2,1,0,4,3,2,5,2,16,2,1,6
2021-04-01,334,1061,8,24393,833991,13135500,809598,6227,2,2,1,2,0,3,2,1,0,4,3,2,5,2,16,2,1,6
2021-04-02,419,633,15,24179,834410,13159679,810231,6242,2,2,1,2,0,3,2,1,0,4,3,2,5,2,16,2,1,6
2021-04-03,123,460,7,23842,834533,13183521,810691,6249,2,2,1,2,0,3,2,1,0,4,3,2,5,2,16,2,1,6
2021-04-04,197,1047,8,22992,834730,13206513,811738,6257,2,2,1,2,0,3,2,1,0,4,3,2,5,2,16,2,1,6
2021-04-05,383,508,6,22867,835113,13229380,812246,6263,2,2,1,2,0,3,2,1,0,4,3,2,5,2,16,2,1,6
2021-04-06,307,491,8,22683,835420,13252063,812737,6271,2,2,1,2,0,3,2,1,0,4,3,2,5,2,16,2,1,6
2021-04-07,273,425,9,22531,835693,13274594,813162,6280,2,2,1,2,0,3,2,1,0,4,3,2,5,2,16,2,1,6
2021-04-08,212,636,9,22107,835905,13296701,813798,6289,2,2,1,2,0,3,2,1,0,4,3,2,5,2,16,2,1,6
2021-04-09,226,577,10,21756,836131,13318457,814375,6299,2,2,1,2,0,3,2,1,0,4,3,2,5,2,16,2,1,6
2021-04-10,86,385,9,21457,836217,13339914,814760,6308,2,2,1,2,0,3,2,1,0,4,3,2,5,2,16,2,1,6
2021-04-11,141,775,6,20823,836358,13360737,815535,6314,2,2,1,2,0,3,2,1,0,4,3,2,5,2,16,2,1,6
2021-04-12,224,357,6,20690,836582,13381427,815892,6320,2,2,1,2,0,3,2,1,0,4,3,2,5,2,16,2,1,6
2021-04-13,198,376,13,20512,836780,13401939,816268,6333,2,2,1,2,0,3,2,1,0,4,3,2,5,2,16,2,1,6
2021-04-14,195,482,3,20225,836975,13422164,816750,6336,2,2,1,2,0,3,2,1,0,4,3,2,5,2,16,2,1,6
2021-04-15,95,260,3,20060,837070,13442224,817010,6339,2,2,1,2,0,3,2,1,0,4,3,2,5,2,16,2,1,6
2021-04-16,110,365,5,19805,837180,13462029,817375,6344,2,2,1,2,0,3,2,1,0,4,3,2,5,2,16,2,1,6
2021-04-17,89,211,7,19683,837269,13481712,817586,6351,2,2,1,2,0,3,2,1,0,4,3,2,5,2,16,2,1,6
2021-04-18,222,543,4,19362,837491,13501074,818129,6355,1,2,1,2,0,2,2,1,0,4,3,2,5,2,16,2,1,6
2021-04-19,150,198,3,19314,837641,13520388,818327,6358,1,2,1,2,0,2,2,1,0,4,3,2,5,2,16,2,1,6
2021-04-20,177,225,4,19266,837818,13539654,818552,6362,1,2,1,2,0,2,2,1,0,4,3,2,5,2,16,2,1,6
2021-04-21,123,233,2,19156,837941,13558810,818785,6364,1,2,1,2,0,2,2,1,0,4,3,2,5,2,16,2,1,6
2021-04-22,164,334,2,18986,838105,13577796,819119,6366,1,2,1,2,0,2,2,1,0,4,3,2,5,2,16,2,1,6
2021-04-23,112,265,5,18833,838217,13596629,819384,6371,1,2,1,2,0,2,2,1,0,4,3,2,5,2,16,2,1,6
2021-04-24,36,113,4,18756,838253,13615385,819497,6375,1,2,1,2,0,2,2,1,0,4,3,2,5,2,16,2,1,6
2021-04-25,85,191,1,18650,838338,13634035,819688,6376,1,2,1,2,0,2,2,1,0,4,3,2,5,2,16,2,1,6
2021-04-26,105,145,3,18610,838443,13652645,819833,6379,1,2,1,2,0,2,2,1,0,4,3,2,5,2,16,2,1,6
2021-04-27,126,148,6,18588,838569,13671233,819981,6385,1,2,1,2,0,2,2,1,0,4,3,2,5,2,16,2,1,6
2021-04-28,112,176,0,18524,838681,13689757,820157,6385,1,2,1,2,0,2,2,1,0,4,3,2,5,2,16,2,1,6
2021-04-29,102,168,2,18458,838783,13708215,820325,6387,1,2,1,2,0,2,2,0,0,4,3,2,5,2,16,2,1,6
2021-04-30,79,130,2,18407,838862,13726622,820455,6389,1,2,1,2,0,2,2,0,0,4,3,2,5,2,16,2,1,6
2021-05-01,15,71,2,18351,838877,13744973,820526,6391,1,2,1,2,0,2,2,0,0,4,3,2,5,2,16,2,1,6
2021-05-02,60,216,1,18195,838937,13763168,820742,6392,1,2,1,2,0,2,2,0,0,4,3,2,5,2,16,2,1,6
2021-05-03,97,152,3,18140,839034,13781308,820894,6395,1,2,1,2,0,2,2,0,0,4,3,2,5,2,16,2,1,6
2021-05-04,68,108,2,18100,839102,13799408,821002,6397,1,2,1,2,0,2,2,0,0,4,3,2,5,2,16,2,1,6
2021-05-05,75,139,2,18036,839177,13817444,821141,6399,1,2,1,2,0,2,2,0,0,4,3,2,5,2,16,2,1,6
2021-05-06,56,143,2,17949,839233,13835393,821284,6401,1,2,1,2,0,2,2,0,0,4,3,2,5,2,16,2,1,6
2021-05-07,34,87,2,17896,839267,13853289,821371,6403,1,2,1,2,0,2,2,0,0,4,3,2,5,2,16,2,1,6
2021-05-08,16,64,1,17848,839283,13871137,821435,6404,1,2,1,2,0,2,2,0,0,4,3,2,5,2,16,2,1,6
2021-05-09,34,145,1,17737,839317,13888874,821580,6405,1,2,1,2,0,2,2,0,0,4,3,2,5,2,16,2,1,6
2021-05-10,76,57,2,17756,839393,13906630,821637,6407,1,2,1,2,0,2,2,0,0,4,3,2,5,2,16,2,1,6
2021-05-11,40,85,1,17711,839433,13924341,821722,6408,1,2,1,2,0,2,2,0,0,4,3,2,5,2,16,2,1,6
2021-05-12,29,93,1,17647,839462,13941988,821815,6409,1,2,1,2,0,2,2,0,0,4,3,2,5,2,16,2,1,6
2021-05-13,35,74,2,17608,839497,13959596,821889,6411,1,2,1,2,0,2,2,0,0,4,3,2,5,2,16,2,1,6
2021-05-14,27,64,0,17571,839524,13977167,821953,6411,1,2,1,2,0,2,2,0,0,4,3,2,5,2,16,2,1,6
2021-05-15,20,45,1,17546,839544,13994713,821998,6412,1,2,1,2,0,2,2,0,0,4,3,2,5,2,16,2,1,6
2021-05-16,38,99,1,17485,839582,14012198,822097,6413,1,2,1,2,0,2,2,0,0,4,3,2,5,2,16,2,1,6
2021-05-17,15,18,3,17482,839597,14029680,822115,6416,1,2,1,2,0,2,2,0,0,4,3,2,5,2,16,2,1,6
2021-05-18,28,90,0,17420,839625,14047100,822205,6416,1,2,1,2,0,2,2,0,0,4,3,2,5,2,16,2,1,6
2021-05-19,56,89,1,17387,839681,14064487,822294,6417,1,2,1,2,0,2,2,0,0,4,3,2,5,2,16,2,1,6
2021-05-20,38,74,0,17351,839719,14081838,822368,6417,1,2,1,2,0,2,2,0,0,4,3,2,5,2,16,2,1,6
2021-05-21,22,34,2,17339,839741,14099177,822402,6419,1,2,1,2,0,2,2,0,0,4,3,2,5,2,16,2,1,6
2021-05-22,12,25,0,17326,839753,14116503,822427,6419,1,2,1,2,0,2,2,0,0,4,3,2,5,2,16,2,1,6
2021-05-23,30,85,1,17271,839783,14133774,822512,6420,1,2,1,2,0,2,2,0,0,4,3,2,5,2,16,2,1,6
2021-05-24,30,30,1,17271,839813,14151045,822542,6421,1,2,1,2,0,2,2,0,0,4,3,2,5,2,16,2,1,6
2021-05-25,23,42,1,17252,839836,14168297,822584,6422,1,2,1,2,0,2,2,0,0,4,3,2,5,2,16,2,1,6
2021-05-26,19,36,0,17235,839855,14185532,822620,6422,1,2,1,2,0,2,2,0,0,4,3,2,5,2,16,2,1,6
2021-05-27,17,38,2,17214,839872,14202746,822658,6424,1,2,1,2,0,2,2,0,0,4,3,2,5,2,16,2,1,6
2021-05-28,18,40,1,17192,839890,14219938,822698,6425,1,2,1,2,0,2,2,0,0,4,3,2,5,2,16,2,1,6
2021-05-29,13,17,0,17188,839903,14237126,822715,6425,1,2,1,2,0,2,2,0,0,4,3,2,5,2,16,2,1,6
2021-05-30,4,69,0,17123,839907,14254249,822784,6425,1,2,1,2,0,2,2,0,0,4,3,2,5,2,16,2,1,6
2021-05-31,15,28,0,17110,839922,14271359,822812,6425,1,2,1,2,0,2,2,0,0,4,3,2,5,2,16,2,1,6
2021-06-01,35,36,2,17109,839957,14288468,822848,6427,1,1,0,0,0,2,2,0,0,4,3,2,5,2,16,2,1,6
2021-06-02,13,49,0,17073,839970,14305541,822897,6427,1,1,0,0,0,2,2,0,0,4,2,2,5,2,16,2,1,6
2021-06-03,11,130,1,16954,839981,14322495,823027,6428,1,1,0,0,0,2,2,0,0,4,2,2,5,2,16,2,1,6
2021-06-04,31,12,0,16973,840012,14339468,823039,6428,1,1,0,0,0,2,2,0,0,4,2,2,5,2,16,2,1,6
2021-06-05,6,6,1,16973,840018,14356441,823045,6429,1,1,0,0,0,2,2,0,0,4,2,2,5,2,16,2,1,6
2021-06-06,5,54,0,16924,840023,14373365,823099,6429,1,1,0,0,0,2,2,0,0,4,2,2,5,3,5,2,1,7
2021-06-07,7,52,1,16879,840030,14390244,823151,6430,1,1,0,0,0,2,2,0,0,4,2,2,5,3,5,2,1,7
2021-06-08,30,15,1,16894,840060,14407138,823166,6431,1,1,0,0,0,2,2,0,0,4,2,2,5,3,5,2,1,7
2021-06-09,9,21,1,16882,840069,14424020,823187,6432,1,1,0,0,0,2,2,0,0,4,2,2,5,3,5,2,1,7
2021-06-10,18,32,0,16868,840087,14440888,823219,6432,1,1,0,0,0,2,2,0,0,4,2,2,5,3,5,2,1,7
2021-06-11,18,19,0,16867,840105,14457755,823238,6432,1,1,0,0,0,2,2,0,0,4,2,2,5,3,5,2,1,7
2021-06-12,5,14,0,16858,840110,14474613,823252,6432,1,1,0,0,0,2,2,0,0,4,2,2,5,3,5,2,1,7
2021-06-13,3,28,1,16833,840113,14491446,823280,6433,1,1,0,0,0,2,2,0,0,4,2,2,5,3,5,2,1,7
2021-06-14,26,21,0,16838,840139,14508284,823301,6433,1,1,0,0,0,2,2,0,0,4,2,2,5,3,5,2,1,7
